NO ./textures/bluestone.xpm

NO ./textures/colorstone.xpm

WE ./textures/eagle.xpm

EA ./textures/greystone.xpm

F 10,80,0

C 25,100,220

111111111111111111111111111111111111111111
100000000000000000000000000000000000000001
101111111111111111111111111111111111111101
101000000000000000000000000000000000000101
101001111111111111111111111111111111100101
101001000000000000000000000000000000100101
101001001111111111111111111111111100100101
101001001000000000000000000000000100100101
101001001001111111111111111111100100100101
101001001001000000000000000000100100100101
101001001001001111111111111100100100100101
101001001001001000000000000100100100100101
101001001001001001111111100100100100100101
101001001001001001000000100100100100100101
101001001001001001001111100100100100100101
101001001001001001001000100100100100100101
101001001001001001001001100100100100100101
101001001001001001001001111100100100100101
101001001001001001001000000000100100100101
101001001001001001001111111111100100100101
101001001001001001000000000000000100100101
101001001001001001111111111111111100100101
101001001001001000000000000000000100100101
101001001001111111111111111111111100100101
101001001000000000000000000000000100100101
101001001111111111111111111111111100100101
101001000000000000000000000000000100100101
101001111111111111111111111111111100100101
101000000000000000000000000000000100100101
101111111111111111111111111111111100100101
100000000000000000000000000000000000100101
111111111111111111111111111111111111111101
100000000000000000000000000000000000000001
101111111111111111111111111111111111111101
101000000000000000000000000000000000000101
101111111111111111111111111111111111111101
1000000000000000000000N0000000000000000001
111111111111111111111111111111111111111111
