SO ./textures/colorstone.xpm

WE ./textures/eagle.xpm

EA ./textures/greystone.xpm

NO ./textures/bluestone.xpm


F 220,100,0

C 225,30,0


1111111111111111111111111111111111111111
100000000000000000S000000000000000000001
1000000000000000000000000000000000000001
1000000000000000000000000000000000000001
1000000000000000000000000000000000000001
1000000000000000000000000000000000000001
1000000000000000000000000000000000000001
1000000000000000000000000000000000000001
1000000000000000011111000000000000000001
1000000000000000011111000000000000000001
1000000000000000011111000000000000000001
1000000000000000011111000000000000000001
1000000000000000000000000000000000000001
1000000000000000000000000000000000000001
1000000000000000000000000000000000000001
1000000000000000000000000000000000000001
1000000000000000000000000000000000000001
1000000000000000000000000000000000000001
1000000000000000000000000000000000000001
1111111111111111111111111111111111111111


