NO ./textures/bluestone.xpm

SO ./textures/colorstone.xpm

WE ./textures/eagle.xpm

EA ./textures/greystone.xpm

F 10,80,0

C 25,100,220


1111111111111
1000000000001
1000000000001
1000000000001
1000000000001
1000000000001
1000000000001
1000000000001
100S000000001
1000000000001
1000000000001
1000000000001
1111111111111
