
11111111111111111111
10000000000000000001
1000000000000000001
10000000E000000001
10000000000000001
1000000000000001
111111111111111
