111111111
1000111111
101011011
1000000000001
1111111111111
